1111100000/
1111111110/
1111101010/
1111110010/
1111111110/
0011101000/
0011111100/
0111111000/
0000000000/
0000000010