0100000000/
0101111110/
0101000010/
0111000010/
0001111110/
0001000000/
0111000000/
0101111110/
0111000010/
0000000010