1010011101/
1110001010/
0110111010/
1100100110/
1011101001/
1110001110/
0010101010/
0111110110/
0100011110/
1110010111